type octile
height 49
width 49
map
TTTTTTTTTTTTTTTTTTTTTTTTTTTTTTTTTTTTTTTTTTTTTTTTT
T...........TTTT.TTT...TTTT.TTTT...............TT
T...T.......TTT........TTT..TTT................TT
T...T...........................................T
T...T...........................................T
T...............................................T
T...............................................T
T.......................TT......................T
T......................TTT......................T
T.................TTTTTTTTT.....................T
T.................T.......T.....................T
T................TT.......T.....................T
T................T........T.....................T
T................T........T.....................T
T................T........T.....................T
TTT............TTTT.......TTTTTTTTT............TT
TTT............TTTT............TTTT............TT
TTT............TTTT............TTTT............TT
TT.............TTT.............TTT.............TT
TT..............................................T
TT..............................................T
TT..............................................T
TT..............................................T
T...............................................T
T...............................................T
T...............................................T
TT..............................................T
TTT.............................................T
TTT.............................................T
TTT.............................................T
T...............................................T
TTT............TTTT............TTTT............TT
TTT............TTTT............TTTT............TT
TTT............TTTT............TTTT............TT
TT.............TTT.............TTT.............TT
T...............................................T
T...............................................T
T...............................................T
T...............................................T
T...............................................T
T...............................................T
T...............................................T
T...............................................T
T...............................................T
T...............................................T
T...............................................T
T...................TTT...TTT...................T
TTT............TTTT.TTTT..TTTT.TTTT............TT
TTTTTTTTTTTTTTTTTTTTTTTTTTTTTTTTTTTTTTTTTTTTTTTTT
